#NESW
#MRBL
D4,2,0,0
O0,0,0,0
-------
D3,0,0,1
O4,2,0,0
-------
D0,0,2,4
O0,0,1,0
-------
D0,3,1,0
O0,0,1,0
-------
